{
    "width": 64,
    "height": 32,
    "spawn": [30, 1],
    "places": {},
    "grid": [
    
    
    
        "                            #$$$#                               ",
        "                            #+++#                               ",
        "                            #+++#                               ",
        "                            #+++#                               ",
        "                            #.++#                               ",
        "                            #+..#                               ",
        "                            #.+.#                               ",
        "                            #...#                               ",
        "                            #...#                               ",
        "                            #...#                               ",
        "          ###################...###################             ",
        "          #.......................................#             ",
        "          #.......................................#             ",
        "          #.......................................#             ",
        "          #........g.....................g........#             ",
        "          #.......................................#             ",
        "          #.......................................#             ",
        "          #.......................................#             ",
        "          #.......................................#             ",
        "          #.......................................#             ",
        "          #.......................................#             ",
        "          #.......................................#             ",
        "          #........g......................g.......#             ",
        "          #.......................................#             ",
        "          #.......................................#             ",
        "          #.......................................#             ",
        "          #.......................................#             ",
        "          #.......................................#             ",
        "          #...................T...................#             ",
        "          #.......................................#             ",
        "          #########################################             ",
        "                                                                "
    ],
    "mapping": {
        ",": "grass",
        "Y": ["grass", "plant"],
        "~": "water",
        "o": ["grass", "stone"],
        "*": ["grass", "pebble"],
        "d": ["grass", "dummy"],
        "#": "wall",
        ":": ["ground", "seed"],
        ".": "ground",
        "+": "floor",
        "^": ["spiketrap"],
        "r": ["grass", "rabbit"],
        "$": {
            "type": "roomexit",
            "args": ["basement", "toarena"],
            "kwargs": {"sprite": "floor"}
        },
        "g": [
            "ground", 
            {
                "type": "spawner",
                "args": [
                    "goblin",
                    2,
                    50,
                    "portal",
                    "goblinspawner"
                ]
            }
        ],
        "T": [
            "ground", 
            {
                "type": "spawner",
                "args": [
                    "troll",
                    1,
                    200,
                    "portal",
                    "trollspawner"
                ]
            }
        ],
        " ": []
    }
}
