{
    "width": 64,
    "height": 64,
    "spawn": [30, 20],
    "places": {
        "stairup": [30, 20],
        "toarena": [30, 30]
    },
    "grid": [
        "                                                                ",
        "                                                                ",
        "                                                                ",
        "                                                                ",
        "                                                                ",
        "                                                                ",
        "                                                                ",
        "                                                                ",
        "                                                                ",
        "                                                                ",
        "                                                                ",
        "                                                                ",
        "                                                                ",
        "                                                                ",
        "                                                                ",
        "                    #####################                       ",
        "                    #+++++++++++++++++++#                       ",
        "                    #+++++++++++++++++++#                       ",
        "                    #+++++++++++++++++++#                       ",
        "                    #+++++++++++++++++++#                       ",
        "                    #+++++++++<+++++++++#                       ",
        "                    #+++++++++++++++++++#                       ",
        "                    #+++++++++++++++++++#                       ",
        "                    #+++++++++++++++++++#                       ",
        "                    #+++++++++++++++++++#                       ",
        "                    #########+++#########                       ",
        "                            #+++#                               ",
        "                            #+++#                               ",
        "                            #+++#                               ",
        "                            #+++#                               ",
        "                            #+++#                               ",
        "                            #+++#                               ",
        "                            #+++#                               ",
        "                            #+++#                               ",
        "                            #+++#                               ",
        "                            #+++#                               ",
        "                            #.++#                               ",
        "                            #+..#                               ",
        "                            #.+.#                               ",
        "                            #...#                               ",
        "                            #...#                               ",
        "                            #...#                               ",
        "          ###################...###################             ",
        "          #.......................................#             ",
        "          #.......................................#             ",
        "          #.......................................#             ",
        "          #........g.....................g........#             ",
        "          #.......................................#X            ",
        "          #........................................X            ",
        "          #.......................................#X            ",
        "          #.......................................#             ",
        "         X#.......................................#             ",
        "       XXX........................................#             ",
        "       X..........................................#             ",
        "       X...........g......................g.......#             ",
        "       XX.........................................#             ",
        "        X.........................................#             ",
        "        XX#.......................................#             ",
        "          #.......................................#             ",
        "          #...##..................................#             ",
        "          #.....#.............T..............##...#             ",
        "          #.......................................#             ",
        "          ###############...........###############             ",
        "                        XXXXXXXXXXXXX                           "
    ],
    "mapping": {
        ",": "grass",
        "Y": ["grass", "plant"],
        "~": "water",
        "o": ["grass", "stone"],
        "*": ["grass", "pebble"],
        "d": ["grass", "dummy"],
        "#": "wall",
        "X": "rock",
        ".": "ground",
        "+": "floor",
        ":": ["floor", "seed"],
        "^": ["spiketrap"],
        "r": ["grass", "rabbit"],
        "<": [{
            "type": "roomexit",
            "args": ["begin", "stairdown"],
            "kwargs": {"sprite": "stairup", "size": 1}
        }, "floor"],
        "g": [
            "ground", 
            {
                "type": "spawner",
                "args": [
                    "goblin",
                    2,
                    50,
                    "portal",
                    "goblinspawner",
                    1,
                    true,
                    true
                ]
            }
        ],
        "T": [
            "ground", 
            {
                "type": "spawner",
                "args": [
                    "troll",
                    1,
                    200,
                    "portal",
                    "trollspawner",
                    1,
                    true,
                    true
                ]
            }
        ],
        " ": []
    }
}
