{
    "width": 64,
    "height": 64,
    "spawn": [21, 16],
    "places": {
        "stairup": [38, 23],
        "ratplace": [22, 17]
    },
    "grid": [
        "                                                                ",
        "                                                                ",
        "                                                                ",
        "                                                                ",
        "                                                                ",
        "                                                                ",
        "                                                                ",
        "                                                                ",
        "                                                                ",
        "                                                                ",
        "                                                                ",
        "                                                                ",
        "                                                                ",
        "                                                                ",
        "                                                                ",
        "                    ###########                                 ",
        "                    #+++++++++#                                 ",
        "                    #+>+++++++#                                 ",
        "                    #+++++++++#                                 ",
        "                    #+++++++++#                                 ",
        "                    #+++++++a+#    #######                      ",
        "                    #+++a+++++#    #+++++#                      ",
        "                    #++++a++++#    #+++++#                      ",
        "                    ###########    #++<++#                      ",
        "                                   #+++++#                      ",
        "                                   #+++++#                      ",
        "                                   ##+++##                      ",
        "                                    #+++#                       ",
        "                                    #+++#                       ",
        "                                    #+++#                       ",
        "                                    #+++#                       ",
        "                                    #+++#                       ",
        "                                    #+++#                       ",
        "                                    #+++#                       ",
        "                                    #.++#                       ",
        "                                    #+.+#                       ",
        "                                XXXXX.++#                       ",
        "                             XXXX.......X                       ",
        "                            XX..........X                       ",
        "                            X..........XX                       ",
        "                            X......XXXXX                        ",
        "                           XX.....XX                            ",
        "          XXXXXXXXXXXXXXXXXX....XXXXXXXXXXXXXXXXXXX             ",
        "          #.......................................#             ",
        "          #.......................................#             ",
        "          #.......................................#             ",
        "          #........g.....................g........#             ",
        "          #.......................................#X            ",
        "          #........................................X            ",
        "          #.......................................#X            ",
        "          #.......................................#             ",
        "         X#.......................................#             ",
        "       XXX........................................#             ",
        "       X..........................................#             ",
        "       X...........g......................g.......#             ",
        "       XX.........................................#             ",
        "        X.........................................#             ",
        "        XX#.......................................#             ",
        "          #.......................................#             ",
        "          #...##..................................#             ",
        "          #.....#.............T..............##...#             ",
        "          #.......................................#             ",
        "          ###############...........###############             ",
        "                        XXXXXXXXXXXXX                           "
    ],
    "mapping": {
        ",": "grass",
        "Y": ["grass", "plant"],
        "~": "water",
        "#": "wall",
        "X": "rock",
        ".": "ground",
        "+": "floor",
        "^": ["spiketrap"],
        "r": ["grass", "rabbit"],
        "<": [{
            "type": "roomexit",
            "args": ["begin", "stairdown"],
            "kwargs": {"sprite": "stairup", "size": 1}
        }, "floor"],
        ">": [{
            "type": "roomexit",
            "args": ["begin", "ratstairs"],
            "kwargs": {"sprite": "stairup", "size": 1}
        }, "floor"],
        "a": ["floor", {
            "type": "spawner",
            "args": ["rat", 1, 300],
            "kwargs": {"initialSpawn": true, "setHome": true}
        }],
        "g": [
            "ground", 
            {
                "type": "spawner",
                "args": [
                    "goblin",
                    2,
                    50,
                    "portal",
                    "goblinspawner",
                    1,
                    true,
                    true
                ]
            }
        ],
        "T": [
            "ground", 
            {
                "type": "spawner",
                "args": [
                    "troll",
                    1,
                    200,
                    "portal",
                    "trollspawner",
                    1,
                    true,
                    true
                ]
            }
        ],
        " ": []
    }
}
