{
    "width": 64,
    "height": 32,
    "spawn": [30, 20],
    "places": {
        "stairup": [30, 20],
        "toarena": [30, 30]
    },
    "grid": [
        "                                                                ",
        "                                                                ",
        "                                                                ",
        "                                                                ",
        "                                                                ",
        "                                                                ",
        "                                                                ",
        "                                                                ",
        "                                                                ",
        "                                                                ",
        "                                                                ",
        "                                                                ",
        "                                                                ",
        "                                                                ",
        "                                                                ",
        "                    #####################                       ",
        "                    #...................#                       ",
        "                    #...................#                       ",
        "                    #...................#                       ",
        "                    #...................#                       ",
        "                    #.........<.........#                       ",
        "                    #...................#                       ",
        "                    #...................#                       ",
        "                    #...................#                       ",
        "                    #...................#                       ",
        "                    #########...#########                       ",
        "                            #...#                               ",
        "                            #...#                               ",
        "                            #...#                               ",
        "                            #...#                               ",
        "                            #...#                               ",
        "                            #$$$#                               "
    ],
    "mapping": {
        ",": "grass",
        "Y": ["grass", "plant"],
        "~": "water",
        "o": ["grass", "stone"],
        "*": ["grass", "pebble"],
        "d": ["grass", "dummy"],
        "#": "wall",
        ":": ["floor", "seed"],
        ".": "floor",
        "^": ["spiketrap"],
        "r": ["grass", "rabbit"],
        "<": [{
            "type": "roomexit",
            "args": ["begin", "stairdown"],
            "kwargs": {"sprite": "stairup", "size": 1}
        }, "floor"],
        "$": [{
            "type": "roomexit",
            "args": ["arena"]
        }, "floor"],
        " ": []
    }
}
