{
    "width": 64,
    "height": 32,
    "spawn": [10, 5],
    "places": {
        "stairdown": [30, 20]
    },
    "grid": [
    
        ",,,,,,,,,,,,,,,,,,,,,,,,,,,,,,,,,,,,,,,,,,,,,,,,,,,,,,,,,,,,,,,,",
        ",,,,,,,,,,,,,,,,,,,,,,,,,,,,,,,,,,,,,,,,,,,,,,,,,,,,,,,,,,,,,,,,",
        ",,,,,,,,,,,,,,,,,,,,,,,,,,,,,,,,,,,,,,,,,,,,,,,,,,,,,,,,,,,,,,,,",
        ",,,,,,,,,,,,,,,,,,,,,,,,,,,,,,,,,,,,,,,~~,,,,,,,,,,,,,,,,,,,,,,,",
        ",,,,,,,,,,,,,,,,,,,,,,,,,,,,,,,,,,~~~~~~~~~~,,,,,,,,,,,,,,,,,,,,",
        ",,,,,,o,,,,,,,,,,,*,,,,,,,,,,,,~~~~~~~~~~~~~~,,,,,,,,,,,,,,,,,,,",
        ",,,,,,,,,,,,,,,,,,,,,,,,,,,,,,,,~~~~~~~~~~~,,,,,,,,,,,,,,,,,,,,,",
        ",,,,,,,,,,,,,,,,,,,,,,,,,,,,,,,,,,,~~~~~~,,,,,,,,,,,,,,,,,,,,,,,",
        ",,,,,,,,,,,,,,,,,,,,,,,,,,,,,,,,,,,,,,,,,,,,,,,,,,,,,,,,,,,,,,,,",
        ",,,,,,,,,,,,,,,,,,,,,,,,,o,,,,,,,,,,,,,,,,,,,,,,,,,,,,,,,,,,,,,,",
        ",,,,,,,,,,,,,,,,,,,,,,,,,,,,,,,,,,,,,,,,,,,,,,,,,,,,,,,,,,,,,,,,",
        ",,,,,,,,,,,,,,,,,,,,,,,,,,,,,,,,,,,,,,,,,,,,,,,,,,,,,,,,,,,,,,,,",
        ",,,,,,,,,,,,,,,,,,,,,,,,,,,,,,,,,,,,,,,,,,,,,,,,,,,,,,,,,,,,,,,,",
        ",,,,,,,,,,,,,,,,,,,,,,,,,,,,,,,,,,,,,,,,,,,,,,,,,,,,,,,,,,,,,,,,",
        ",,,,,,,,,,,,,,,,,,,,,,,,,,,,,,,,,,,,,,,,,,,,,,,,,,,,,,,,,,,,,,,,",
        ",,,,,,,,,,,,,,,,,,,,#####################,,,,,,,,,,,,,,,,,,,,,,,",
        ",,,,,*,,,,,,,,,,,,,,#...................#,,,,,,,,,,,,,,,,,,,,,,,",
        ",,,,,,,,,,,,,.,,,,.,#...................#,,,,,,,,,,,,,,,,,,,,,,,",
        ",,,,,,,,,,,.,,,..,,,#...................#,,,,,,,,,,,,,,,,,,,,,,,",
        ",,,,,,,,,,,,,.,.,,......................#,,,,,,,,,,,,,,,,,,,,,,,",
        ",,,,,,,,,,.,,,.,..............>.........#,,,,,,,,,,,,,,,,,,,,,,,",
        ",,,,,,,,,,,,,..,....#...................#,,,,,,,,,,,,,,,,,,,,,,,",
        ",,,,,,,,,,,,,#......#...................#,,,,,,,,,,,,,,,,,,,,,,,",
        ",,,,,,,,,,,,,#.d..^.#...................#,,,,,,,,,,,,,,,,,,,,,,,",
        ",,,,,,,,,,,,,########...................#,,,,,,,,,,,,,,,,,,,,,,,",
        ",,,,,,,,,,,,,,,,,,,,#####################,,,,,,,,,,,,,,,,,,,,,,,",
        ",,,,,,,,,,,,,,,,,,,,,,,,,,,,,,,,,,,,,,,,,,,,,,,,,r,,,,,,,,,,,,,,",
        ",,,,,,,,,,,,,,,,,,,,,,,,,,,,,,,,,,,,,,,,,,,,,,,,,,,,,,,,,,,,,,,,",
        ",,,,,,,,,,,,,,,,,,,,,,,,,,,,,,,,,,,,,,,,,,,,,,,r,,,r,,,,,,,,,,,,",
        ",,,,,,,,,,,,,,,,,,,,,,,,,,,,,,,,,,,,,,,,,,,,,,,,,,,,,,,,,,,,,,,,",
        ",,,,,,,,,,,,,,,,,,,,,,,,,,,,,,,,,,,,,,,,,,,,,,,,,,r,,,,,,,,,,,,,",
        ",,,,,,,,,,,,,,,,,,,,,,,,,,,,,,,,,,,,,,,,,,,,,,,,,,,,,,,,,,,,,,,,"
    ],
    "mapping": {
        ",": "grass",
        "Y": ["grass", "plant"],
        "~": "water",
        "o": ["grass", "stone"],
        "*": ["grass", "pebble"],
        "d": ["grass", "dummy"],
        "#": "wall",
        ":": ["ground", "seed"],
        ".": "ground",
        "^": ["spiketrap"],
        ">": {
            "type": "roomexit",
            "args": ["basement","stairup"],
            "kwargs": {"sprite": "stairdown"}
        },
        "r": ["grass", "rabbit"]
    }
}
