{
    "width": 64,
    "height": 64,
    "spawn": [10, 15],
    "places": {
        "stairdown": [30, 30]
    },
    "grid": [
    
        ",,,,,,,,,,,,,,,,,,,,,,,,,,,~~~~~~~~~~~~~~~~~~~~~~~~~~~~~~~~~~~~~",
        ",,,,,,,,,,,,,,,,,~~~~~~~~~~~~~~~~~~~~~~~~~~~~~~~~~~~~~~~~~~~~~~~",
        ",,,,,,,,,,,,~~~~~~~~~~~~~~~~~~~~~~~~~~~~~~~~~~~~~~~~~~~~~~~~~~~~",
        ",,,,,,,,~~~~~~~~~~~~~~~~~~~~~~~~~~~~~~~~~~~,,,,,,,,,,,,,,,,,,,,,",
        ",,,,,,~~~~~~~~~~~~~~~~~~~~~~~~,,,,,,,,,,,,,,,,,,,,,,,,,,,,,,,,,,",
        ",,,,~~~~~~~~~~~~~~~,,,,,,,,,,,,,,,,,,,,,,,,,,,,T,,,,,,,,,,,,,,,,",
        ",,,~~~~~~~~~~~,,,,,,,,,,,,,,,,,,,,,,,,,T,,,,,,,,,,,,,,,,,,,,,,,,",
        ",,~~~~~~~~~,,,,,,,,,,,,,,,,,,,,,,,,,,,,,,,,,,,,,,,,,,,,,,,,,,,,,",
        ",,~~~~~~,,,,,,,,,,,,,,,,,,,,,,,,,,,,,,,,,,,T,,,,,,T,,,,,,,,,,,,,",
        ",~~~~~~,,,,,,,,,,,,,,,,,,,,,,,,,,,,,,,,,,,,,,,,,,,,,,,,,,,,,,,,,",
        ",~~~~~,,,,,,,,,,,,,,,,,T,,,,,,,,,,,,,,,,,,,,,,,T,,,,,,,,,,,,,,,,",
        "~~~~~~,,,,,,,,,,,,,,,,,,,,T,,,,,,,,,,,,,,,,,,,,,,,,,,,,,,,,,,,,,",
        "~~~~~,,,,T,,,,,,,,,,,,,,,,,,,,,,,,,,,,,,,,,,,,,,,,,,,,,,,,,,,,,,",
        "~~~~~,,,,,,,,,,,,,,,,,,,,,,,,,,,,,,,,,,,,,,,,,,,,,,,,,,,,,,,,,,,",
        "~~~~~,,,,,,,,,,,,,,,,,,,,,,,,,,,,,,,,,,,,,,,,,,,,,,,,,,,,,,,,,,,",
        "~~~~~,o,,,,,,,,,,,*,,,,,,,,,,,,,,,,,,,,,,,,,,,,,,,,,,,,,,,,,,,,,",
        "~~~~~,,,,,,,,,,,,,,,,,,,,,,,,,,,,,,,,,,*,,,,,,,,,,,T,,,,,,,,,,,,",
        "~~~~~,,,,,,,,,,,,,,,,,,,,,,,,,,,,,,,,,,,,,,,,,,,,,,,,,,,,,,,,,,,",
        ",~~~~,,,,,,,,,,,,,,,,,,,,,,,,,,,,,,,,,,,,,,,,,,,,,,,,,,,,,,,,,,,",
        ",~~~~,,,,,,,,,,,,,,,,,,,,o,,,,,,,,,,,,,,T,,,,,,,,,,,,,,,,,,,,,,,",
        ",~~~~~,,,,,,,,,,,,,,,,,,,,,,,,,,,,T,,,,,,,,,,,,,,,,,,,,,,,,,,,,,",
        ",~~~~~,,,!,,,,,,,,,,,,,,,,,,,,,,,,,,,,,,,,,,,,,,,,,,,,,,,,,,,,,,",
        ",~~~~~,,,,,,,,,,,,,,,/,,,,,,,,,,,,,,,,,,,,,,,,,,,,,,,,,,,,,,,,,,",
        ",~~~~~,,,,,,,,,,,,,,,,,,,,,,,,,,,,,,,,,,,,,,,,,,,,,,,,,,,,,,,,,,",
        ",~~~~~,,,,,,,,,,,,,,,,,,,,,,,,,,,,,,,,,,,,,,,T,,,,,,,,,,,,,,,,,,",
        ",~~~~~,,,,,,,,,,,,,,#####################,,,,,,,,,,,,,,,,,,,,,,,",
        ",~~~~~,,,,,,,,,,,,,,#::+++++++++++++++++#,,,,,,,,,,,,,,,,,,,,,,,",
        ",~~~~~,,,,,,,.,,,,.,#:++++++++++++++++++#,,,,,,,,,,,,,,,,,,,,,,,",
        "~~~~~,,,,,,.,,,..,,,#+++++++++++++++++++#,,,,,,,,,,,,,,,,,,,,,,,",
        "~~~~~,,,,,,,,.,.,,...+++++++++++++++++++#,,,,,,,,,,,,,,,,,,,,,,,",
        "~~~~~,,,,,.,,,.,.....+++++++++>+++++++++#,,,,,,,,,,,,,,,,,,,,,,,",
        "~~~~~,,,,,,,,..,....#+++++++++++++++++++#,,,,,,,,,,,,,,,,,,,,,,,",
        "~~~~,,,,,,,,,#d.....#+++++++++++++++++++#,,,,,,,,,,,,,,,,,,,,,,,",
        "~~~~,,,,,,,,,#..d..^#+++++++++++++++++++#,,,,,,,,,,,,,,,,,,,,,,,",
        "~~~~,,,,,,,,,########+++++++++++++++++++#,,,,,,,,,,,,,,,,,,,,,,,",
        "~~~~,,,,,,,,,,,,,,,,#####################,,,,,,,,,,,,,,,,,,,,,,,",
        "~~~~,,,,,,,,,,,,,,,,,,,,,,,,,,,,,,,,,,,,,,,,,,,,,r,,,,,,,,,,,,,,",
        "~~~~~,,,,,,,,,,,,,,,,,,,,,,,,,,,,,,,,,,,,,,,,,,,,,,,,,,,,,,,,,,,",
        "~~~~~,,,,,,,,,,,,,,,,,,,,,,,,,,,,,,,,,,,,,,,,,,r,,,r,,,,,,,,,,,,",
        "~~~~~~,,,,,,,,,,,,,,,,,,,,,,,,,,,,,,,,,,,,,,,,,,,,,,,,,,,,,,,,,,",
        ",~~~~~,,,,,,,T,,,,,,,,,,,,,,,,,,,,,,,,,,,,,,,,,,,,r,,,,,,,,,,,,,",
        ",~~~~~~,,,,,,,,,,,,,,,,,,,,,,,,,,,,,,,,,,,,,,,,,,,,,,,,,,,,,,,,,",
        ",~~~~~~,,,,,,,,,,,,,,,,,,,,,,,,,,,,,,,,,,,,,,,,,,,,,,,,,,,,,,,,,",
        ",,~~~~~,,,,,,,,,,,,,,,,,,,,,,,,,,,,,,,,T,,,,,,,,,,,,,,,,,,,,,,,,",
        ",,~~~~~,,,,,,,,,,,,,,,,,,,,,,,,,,,,,,,,,,,,,,,,T,,,,,,,,,,,,,,,,",
        ",,~~~~~,,,,,,,,,,,,,,,,,,,,,,,,T,,,,,,,,,,,,,,,,,,,,,,,,,,,,,,,,",
        ",,~~~~~,,,,,,,T,,,,,,,,,,,,,,,,,,,,,T,,,,,T,,,,,,,,T,,,,,,,,,,,,",
        ",,~~~~~,,,,,,,,,,,,,,,,,,,T,,,,,,,,,,,,,,,,,,,T,,,,,,,,,,,,,,,,,",
        ",,~~~~~,,,,,,,,,,,,,,,,,,,,,,,,,T,,,,,,,,,,T,,,,,,,,,,,,T,,,,,,,",
        ",,~~~~~,,,,,,,,,,,,,,,,,,,,,,,,,,,,,,,T,,,,,,,,,,,,,,,,,,,,,,,,,",
        ",~~~~~~,,,,,,,,,,,,,,XXXXXXXXXX,,,,,,,,,,,,,,,,T,,,,,,,T,,,,,,,,",
        ",~~~~~~,,,,,,,,XXXXXXXXXXXXXXXXXX,,,,,,,T,,,,,,,,,,,,,,,,,,,,,XX",
        ",~~~~~,,,,,,XXXXXXXXXXXXXXXXXXXXXXX,,,,,,,,,,,,T,,,,,,,,,,,,XXXX",
        ",~~~~~,,,,XXXXXXXXXXXXXXXXXXXXXXXXXXXX,,,,,,,,,,,,,,,,,,,,,XXXXX",
        ",~~~~~,,,XXXXXXXXXXXXXX      XXXXXXXXXXX,,,,,,,XX,,,,,,,,,,XXXXX",
        ",~~~~~,,XXXXXXXX               XXXXXXXXXXX,,,XXXXXXX,,,,,,XXXXXX",
        "X~~~~~,,XXXXXXX                  XXXXXXXXX,,XXXXXXXXXXX,,XXXXXX ",
        "X~~~~~,,XXXXXX                     XXXXXXX,XXXXXXXXXXXXXXXXXXX  ",
        "X~~~~~,XXXXXXX                       XXXXXXXXXXXXXXXXXXXXXXXX   ",
        "X~~~~~,XXXXXX                         XXXXXXXXX    XXXXXXXX     ",
        "X~~~~~,,XXXXX                           XXXXXX      XXXXXX      ",
        "X~~~~~XXXXXXX                            XXXX                   ",
        "X~~~~~XXXXXX                                                    ",
        "X~~~~~XXXXXX                                                    "
    ],
    "mapping": {
        ",": "grass",
        "Y": ["grass", "plant"],
        "T": ["grass", "tree"],
        "~": "water",
        "o": ["grass", "stone"],
        "*": ["grass", "pebble"],
        "d": ["ground", "dummy"],
        "#": "wall",
        ":": ["floor", "seed"],
        ".": "ground",
        "+": "floor",
        "X": "rock",
        "^": ["spiketrap", "ground"],
        ">": [{
            "type": "roomexit",
            "args": ["basement","stairup"],
            "kwargs": {"sprite": "stairdown", "size": 1}
        }, "floor"],
        "r": ["grass", "rabbit"],
        "/": ["grass", "sword"],
        "!": ["grass", "club"],
        " ": []
    }
}
