{
    "width": 64,
    "height": 64,
    "spawn": [10, 15],
    "places": {
        "stairdown": [30, 30],
        "right": [62, 10]
    },
    "grid": [
        ",,,,,,,,,,,,,,,,,,,,,,,,,,,~~~~~~~~~~~~~~~~~~~~~~~~~~~~~~~~~~~~~",
        ",,,,,,,,,,,,,,,,,~~~~~~~~~~~~~~~~~~~~~~~~~~~~~~~~~~~~~~~~~~~~~~~",
        ",,,,,,,,,,,,~~~~~~~~~~~~~~~~~~~~~~~~~~~~~~~~~~~~~~~~~~~~~~~~~~~~",
        ",,,,,,,,~~~~~~~~~~~~~~~~~~~~~~~~~~~~~~~~~~~,,,,,,,,,,,,,,,,,,,'1",
        ",,,,,,~~~~~~~~~~~~~~~~~~~~~~~~,,,,,,,,,,,,,,,,,,,,,,,,,,,,,,,,'1",
        ",,,,~~~~~~~~~~~~~~~,,,,,,,,,,,,,,,,,,,,,,,,,,,,T,,,,,,,,,,,,,,'1",
        ",,,~~~~~~~~~~~,,,,,,,,,,,,,,,,,,,,,,,,,T,,,,,,,,,,,,,,,,,,,,,,'1",
        ",,~~~~~~~~~,,,,,,,,,,,,,,,,,,,,,,,,,,,,,,,,,,,,,,,,,,,,,,,,,,,'1",
        ",,~~~~~~,,,,,,,,,,,,,,,,,,,,,,,,,,,,,,,,,,,T,,,,,,T,,,,,,,,,,,'1",
        ",~~~~~~,,,,,,,,,,,,,,,,,,,,,,,,,,,,,,,,,,,,,,,,,,,,,,,,,,,,,,,'1",
        ",~~~~~,,,,,,,,,''''''''T'''''''''''''''''''''''T'''''''''''''''1",
        "~~~~~~,,,,,,,'''''''''''''T''''''''''''''''''''''''''''''''''''1",
        "~~~~~''''T''''.................................................1",
        "~~~~~.'''''''.'''''''''''''''''''''''''''''''''''''''''''''''''1",
        "~~~~~........''',,,,,,,,,,,,,,,,,,,,,,,,,,,''''',,,,,,,,,,,,,,'1",
        "~~~~~.'''...''*',,,,,,,,,,,,,,,,,,,,,,,,,,,''''',,,,,,,,,,,,,,'1",
        "~~~~~''''...'''',,,,,,,,,,,,,,,,,,,,,,,,,,,''''',,,T,,,,,,,,,,'1",
        "~~~~~'''''..'''',,,,,,,,,,,,,,,,,,,,,,,,,,,''''',,,,,,,,,,,,,,'1",
        ",~~~~'''''..'''',,,,,,,,,,,,,,,,,,,,,,,,,,,''''',,,,,,,,,,,,,,'1",
        ",~~~~'''*''.'''',,,,,,,,,,,,,,,,,,,,,,,,T,,''''',,,,,,,,,,,,,,'1",
        ",~~~~~,,,,..'''',,,,,,,,,,,,,,,,,,T,,,,,,,,''''',,,,,,,,,,,,,,'1",
        ",~~~~~,,,,'..''',,,,,,,,,,,,,,,,,,,,,,,,,,,''''',,,,,,,,,,,,,,'1",
        ",~~~~~,,,,''.''',,,,,,,,,,,,,,,,,,,,,,,,,,,''''',,,,,,,,,,,,,,'1",
        ",~~~~~,,,,,'..'',,,,,,,,,,,,,,,,,,,,,,,,,,,''''',,,,,,,,,,,,,,'1",
        ",~~~~~,,,,,''.'',,,,,,,,,,,,,,,,,,,,,,,,,,'''T''',,,,,,,,,,,,,'1",
        ",~~~~~,,,,,'..''''''#####################''''''''',,,,,,,,,,,,'1",
        ",~~~~~,,,,,''..'''''#+++++++++++++++++++#'a''''''',,,,,,,,,,,,'1",
        ",~~~~~'''''''..'''.'#+++++++++++++++++++#''''''''',,,,,,,,,,,,'1",
        "~~~~~''''''''''..'''#+++++++++++++++++++#''''''''',,,,,,,,,,,,'1",
        "~~~~~''''''''.'.''...+++++++++++++++++++#''''''''',,,,,,,,,,,,'1",
        "~~~~~'''''..''.'.....+++++++++>+++++++++#':'''a''',,,,,,,,,,,,'1",
        "~~~~~''''''.'..'....#+++++++++++++++++++#''''''''',,,,,,,,,,,,'1",
        "~~~~,,,,,,'.'#d.....#+++++++++++++++++++#''''''''',,,,,,,,,,,,'1",
        "~~~~,,,,,,'.'#..d..^#+++++++++++++++++++#''''''''',,,,,,,,,,,,'1",
        "~~~~,,,,,,'.'########+++++++++++++++++++#''a'''''',,,,,,,,,,,,'1",
        "~~~~,,,,,,'.',,,,,,,#####################''''''''',,,,,,,,,,,,'1",
        "~~~~,,,,,,'.',,,,,,,,,,,,,,,,,,,,,,,,,,,,''''''''',,,,,,,,,,,,'1",
        "~~~~~,,,,,'.',,,,,,,,,,,,,,,,,,,,,,,,,,,,''''''''',,,,,,,,,,,,'1",
        "~~~~~,,,,,'.'''''''''''''''''''''''''''''''''''''''''''''''''''1",
        "~~~~~~,,,,'....................................................1",
        ",~~~~~,,,,'''T'''''''''''''''''''''''''''''''''''''''''''''''''1",
        ",~~~~~~,,,'''''''''''''''''''''''''''''''''''''''''''''''''''''1",
        ",~~~~~~,,,,,,,,,,,,,,,,,,,,,,,,,,,,,,,,,,,,,',,,,,,,,,,,,,,,,,'1",
        ",,~~~~~,,,,,,,,,,,,,,,,,,,,,,,,,,,,,,,,T,,,,',,,,,,,,,,,,,,,,,'1",
        ",,~~~~~,,,,,,,,,,,,,,,,,,,,,,,,,,,,,,,,,,,,,',,T,,,,r,,,r,,,,,'1",
        ",,~~~~~,,,,,,,,,,,,,,,,,,,,,,,,T,,,,,,,,,,,,',,,,,,,,,,,,,,,,,'1",
        ",,~~~~~,,,,,,,T,,,,,,,,,,,,,,,,,,,,,T,,,,,T,',,,,,,T,,r,,,,,,,'1",
        ",,~~~~~,,,,,,,,,,,,,,,,,,,T,,,,,,,,,,,,,,,,,',T,,,,,,,,,,,,,,,'1",
        ",,~~~~~,,,,,,,,,,,,,,,,,,,,,,,,,T,,,,,,,,,,T,,,,,,,r,,,,T,,,,,'1",
        ",,~~~~~,,,,,,,,,,,,,,,,,,,,,,,,,,,,,,,T,,,,,,,,,,,,,,,,,,,,,,,'1",
        ",~~~~~~,,,,,,,,,,,,,,XXXXXXXXXX,,,,,,,,,,,,,,,,T,,,,,,,T,,,,,,'1",
        ",~~~~~~,,,,,,,,XXXXXXXXXXXXXXXXXX,,,,,,,T,,,,,,,,,,,,,,,,,,,,,XX",
        ",~~~~~,,,,,,XXXXXXXXXXXXXXXXXXXXXXX,,,,,,,,,,,,T,,,,,,,,,,,,XXXX",
        ",~~~~~,,,,XXXXXXXXXXXXXXXXXXXXXXXXXXXX,,,,,,,,,,,,,,,,,,,,,XXXXX",
        ",~~~~~,,,XXXXXXXXXXXXXX      XXXXXXXXXXX,,,,,,,XX,,,,,,,,,,XXXXX",
        ",~~~~~,,XXXXXXXX               XXXXXXXXXXX,,,XXXXXXX,,,,,,XXXXXX",
        "X~~~~~,,XXXXXXX                  XXXXXXXXX,,XXXXXXXXXXX,,XXXXXX ",
        "X~~~~~,,XXXXXX                     XXXXXXX,XXXXXXXXXXXXXXXXXXX  ",
        "X~~~~~,XXXXXXX                       XXXXXXXXXXXXXXXXXXXXXXXX   ",
        "X~~~~~,XXXXXX                         XXXXXXXXX    XXXXXXXX     ",
        "X~~~~~,,XXXXX                           XXXXXX      XXXXXX      ",
        "X~~~~~XXXXXXX                            XXXX                   ",
        "X~~~~~XXXXXX                                                    ",
        "X~~~~~XXXXXX                                                    "
    ],
    "mapping": {
        ",": ["grass", "freeland"],
        "'": ["grass"],
        "Y": ["grass", "plant"],
        "T": ["grass", "tree"],
        "~": "water",
        "=": ["water", "bridge"],
        "o": ["grass", "stone", "stone", "stone", "stone", "stone", "stone", "stone", "stone"],
        "*": ["grass", "pebble"],
        "d": ["ground", {
            "type": "spawner",
            "args": ["dummy", 1, 600],
            "kwargs": {"initialSpawn": true}
        }],
        "#": "wall",
        ":": ["ground", {
            "type": "spawner",
            "args": ["seed", 1, 600],
            "kwargs": {"initialSpawn": false}
        }],
        ";": ["floor", "seed"],
        ".": "ground",
        "+": "floor",
        "X": "rock",
        "^": ["spiketrap", "ground"],
        ">": [{
            "type": "roomexit",
            "args": ["basement","stairup"],
            "kwargs": {"sprite": "stairdown", "size": 1}
        }, "floor"],
        "a": ["ground", {
            "type": "spawner",
            "args": ["rat", 1, 300],
            "kwargs": {"initialSpawn": true, "setHome": true}
        }],
        "r": ["grass", "rabbit"],
        "/": ["grass", "sword"],
        "!": ["grass", "club"],
        "]": ["grass", "armour"],
        "1": [{
            "type": "roomexit",
            "args": ["right", [1, 0], [false, true]]
        }, "grass"],
        " ": []
    }
}
