{
    "width": 64,
    "height": 64,
    "spawn": [23, 55],
    "places": {
        "begin": [36, 55],
        "towneast": [39, 28]
    },
    "grid": [
        ",,,,,,#.#,,,,,,#,,,,,,#.~,,,,,,#,,,,,,#.#,,,,,,#,,,,,,#.#,,,,,,#",
        ",,,,,,#.#,,,,,,#,,,,,,#.~,,,,,,#,,,,,,#.#,,,,,,#,,,,,,#.#,,,,,,#",
        ",,,,,,#.#,,,,,,#,,,,,,#.~,,,,,,#,,,,,,#.#,,,,,,#,,,,,,#.#,,,,,,#",
        ",,,,,,#.#,,,,,,#,,,,,,#.~,,,,,,#,,,,,,#.#,,,,,,#,,,,,,#.#,,,,,,#",
        ",,,,,,#.#,,,,,,#,,,,,,#.~,,,,,,#,,,,,,#.#,,,,,,#,,,,,,#.#,,,,,,#",
        ",,,,,,#.#,,,,,,#,,,,,,#.~,,,,,,#,,,,,,#.#,,,,,,#,,,,,,#.#,,,,,,#",
        "#######.###############.~~#############.###############.########",
        ".........................=......................................",
        "#######.###############.~~#############.###############.########",
        ",,,,,,#.#,,,,,,#,,,,,,#.~.,,,,,#,,,,,,#.#,,,,,,#,,,,,,#.#,,,,,,#",
        ",,,,,,#.#,,,,,,#,,,,,,#.~,,,,,,#,,,,,,#.#,,,,,,#,,,,,,#.#,,,,,,#",
        ",,,,,,#.#,,,,,,#,,,,,,#.~,,,,,,#,,,,,,#.#,,,,,,#,,,,,,#.#,,,,,,#",
        ",,,,,,#.#,,,,,,#,,,,,,#.~,,,,,,#,,,,,,#.#,,,,,,#,,,,,,#.#,,,,,,#",
        ",,,,,,#.#,,,,,,#,,,,,,#.~,,,,,,#,,,,,,#.#,,,,,,#,,,,,,#.#,,,,,,#",
        ",,,,,,#.#,,,,,,#,,,,,,#.~,,,,,,#,,,,,,#.#,,,,,,#,,,,,,#.#,,,,,,#",
        "#######.###############.~##############.###############.########",
        ",,,,,,#.#,,,,,,#,,,,,,#.~,,,,,,#,,,,,,#.#,,,,,,#,,,,,,#.#,,,,,,#",
        ",,,,,,#.#,,,,,,#,,,,,,#.~,,,,,,#,,,,,,#.#,,,,,,#,,,,,,#.#,,,,,,#",
        ",,,,,,#.#,,,,,,#,,,,,,#.~,,,,,,#,,,,,,#.#,,,,,,#,,,,,,#.#,,,,,,#",
        ",,,,,,#.#,,,,,,#,,,,,,#.~,,,,,,#,,,,,,#.#,,,,,,#,,,,,,#.#,,,,,,#",
        ",,,,,,#.#,,,,,,#,,,,,,#.~,,,,,,#,,,,,,#.#,,,,,,#,,,,,,#.#,,,,,,#",
        ",,,,,,#.#,,,,,,#,,,,,,#.~,,,,,,#,,,,,,#.#,,,,,,#,,,,,,#.#,,,,,,#",
        "#######.###############.~~#############.###############.########",
        ".........................=......................................",
        "#######.###############.#~#############.###############.########",
        ",,,,,,#.#,,,,,,#,,,,,,#.#~..^^.^^^^...#.#,,,,,,#,,,,,,#.#,,,,,,#",
        ",,,,,,#.#,,,,,,#,,,,,,#.#~~.^..^^.^..^#.#,,,,,,#,,,,,,#.#,,,,,,#",
        ",,,,,,#.#,,,,,,#,,,,,,#.#.~^..^.....^^#.#,,,,,,#,,,,,,#.#,,,,,,#",
        ",,,,,,#.#,,,,,,#,,,,,,#.#^~~=~~,^^^...2.#,,,,,,#,,,,,,#.#,,,,,,#",
        ",,,,,,#.#,,,,,,#,,,,,,#.#^...^~=~~~=~,#.#,,,,,,#,,,,,,#.#,,,,,,#",
        ",,,,,,#.#,,,,,,#,,,,,,#.#^^...^..^^,~~~=~,,,,,,#,,,,,,#.#,,,,,,#",
        "#######.###############.###############.~##############.########",
        ",,,,,,#.#,,,,,,#,,,,,,#.#,,,,,,#,,,,,,#.~,,,,,,#,,,,,,#.#,,,,,,#",
        ",,,,,,#.#,,,,,,#,,,,,,#.#,,,,,,#,,,,,,#.~,,,,,,#,,,,,,#.#,,,,,,#",
        ",,,,,,#.#,,,,,,#,,,,,,#.#,,,,,,#,,,,,,#.~,,,,,,#,,,,,,#.#,,,,,,#",
        ",,,,,,#.#,,,,,,#,,,,,,#.#,,,,,,#,,,,,,#.~,,,,,,#,,,,,,#.#,,,,,,#",
        ",,,,,,#.#,,,,,,#,,,,,,#.#,,,,,,#,,,,,,#.~,,,,,,#,,,,,,#.#,,,,,,#",
        ",,,,,,#.#,,,,,,#,,,,,,#.#,,,,,,#,,,,,,#.~,,,,,,#,,,,,,#.#,,,,,,#",
        "#######.###############.###############.~~#############.########",
        ".........................................=......................",
        "#######.###############.###############.~~#############.########",
        ",,,,,,#.#,,,,,,#,,,,,,#.#,,,,,,#,,,,,,#.~,,,,,,#,,,,,,#.#,,,,,,#",
        ",,,,,,#.#,,,,,,#,,,,,,#.#,,,,,,#,,,,,,#.~,,,,,,#,,,,,,#.#,,,,,,#",
        ",,,,,,#.#,,,,,,#,,,,,,#.#,,,,,,#,,,,,,#.~,,,,,,#,,,,,,#.#,,,,,,#",
        ",,,,,,#.#,,,,,,#,,,,,,#.#,,,,,,#,,,,,,#.~,,,,,,#,,,,,,#.#,,,,,,#",
        ",,,,,,#.#,,,,,,#,,,,,,#.#,,,,,,#,,,,,,#.~,,,,,,#,,,,,,#.#,,,,,,#",
        ",,,,,,#.#,,,,,,#,,,,,,#.#,,,,,,#,,,,,,#.~,,,,,,#,,,,,,#.#,,,,,,#",
        "#######.###############.###############.~##############.########",
        ",,,,,,#.#,,,,,,#,,,,,,#.#,,,,,,#,,,,,,#.~,,,,,,#,,,,,,#.#,,,,,,#",
        ",,,,,,#.#,,,,,,#,,,,,,#.#,,,,,,#,,,,,,#.~,,,,,,#,,,,,,#.#,,,,,,#",
        ",,,,,,#.#,,,,,,#,,,,,,#.#,,,,,,#,,,,,,#.~,,,,,,#,,,,,,#.#,,,,,,#",
        ",,,,,,#.#,,,,,,#,,,,,,#.#,,,,,,#,,,,,,#.~,,,,,,#,,,,,,#.#,,,,,,#",
        ",,,,,,#.#,,,,,,#,,,,,,#.#,,,,,,#,,,,,,~=~,,,,,,#,,,,,,#.#,,,,,,#",
        ",,,,,,#.#,,,,,,#,,,,,,#.#,,,,,,#,,,,,,~.#,,,,,,#,,,,,,#.#,,,,,,#",
        "#######.###############.##############~.###############.########",
        "......................................=.........................",
        "#######.###############.,,~~~~~~~~~~1~~,###############.########",
        ",,,,,,#.#,,,,,,#,,,,,,#.~~~,,,T,,,,,,,~,#,,,,,,#,,,,,,#.#,,,,,,#",
        ",,,,,,#.#,,,,,,#,,,,,,#.~,,,,,,,,,,,,,~,#,,,,,,#,,,,,,#.#,,,,,,#",
        ",,,,,,#.#,,,,,,#,,,,,,#.~,,^^,,,,,,T,,~,#,,,,,,#,,,,,,#.#,,,,,,#",
        ",,,,,,#.#,,,,,,#,,,,,,#.~,,^^,,,,,,,,,~,#,,,,,,#,,,,,,#.#,,,,,,#",
        ",,,,,,#.#,,,,,,#,,,,,,#.~,,,T,,,,T,,,,~,#,,,,,,#,,,,,,#.#,,,,,,#",
        ",,,,,,#.#,,,,,,#,,,,,,#.~,,,,,,,,,,,,,~,#,,,,,,#,,,,,,#.#,,,,,,#",
        "#######.#############XX+~XXXXXXXXXXXXX~+XXX############.########"
    ],
    "mapping": {
        ",": "grass",
        "Y": ["grass", "plant"],
        "T": ["grass", "tree"],
        "~": "water",
        "=": ["water", {"type": "bridge", "kwargs": {"small": true}}],
        "o": ["grass", "stone"],
        "*": ["grass", "pebble"],
        "d": ["ground", "dummy"],
        "#": "fence",
        ":": ["floor", {
            "type": "spawner",
            "args": ["seed", 1, 600],
            "kwargs": {"initialSpawn": true}
        }],
        ";": ["floor", "seed"],
        ".": "ground",
        "+": "floor",
        "X": "rock",
        "^": "house",
        "1": [{
            "type": "roomexit",
            "args": ["right","bridge"],
            "kwargs": {"sprite": "entry", "size": 1}
        }, "floor"],
        "2": [{
            "type": "roomexit",
            "args": ["town","gate"],
            "kwargs": {"sprite": "entry", "size": 1}
        }, "floor"],
        "r": ["grass", "rabbit"],
        "/": ["grass", "sword"],
        "!": ["grass", "club"],
        "]": ["grass", "armour"],
        " ": []
    }
}
