{
    "width": 64,
    "height": 64,
    "spawn": [10, 10],
    "places": {
        "left": [1, 10],
        "bridge": [34, 1]
    },
    "grid": [
        "~~~~~~~~~~~~~~~~~~~~~~~~~~~~~~~~~%%%~~~~~~~~~~~~~~~~~~~~~~~~~~~~",
        "~~~~~~~~~~~~~~~~~~~~~~~~~~~~~~~~~===~~~~~~~~~~~~~~~~~~~~~~~~~~~~",
        "~~~~~~~~~~~~~~~~~~~~~~~~~~~~~~~~~===~~~~~~~~~~~~~~~~~~~~~~~~~~~~",
        "1',,,,,,,,,,,,,,,,,,,,,,,,,,,,,,'...',,,,,,,,,,,,,,,,,,,,,,~~~~~",
        "1',,,,,,,,,,,,,,,,,,,,,,,,,,,,,,''.'',,,,,,,,,,,,,,,,,,,,,,~~~~~",
        "1',,,,,,,,,,,,,,,,,,,,,,,,,,,,,,,'.',,,,,,,,,,,,,,,,,,,,,,,~~~~~",
        "1',,,,,,,,,,,,,,,,,,,,,,,,,,,,,,,'.',,,,,,,,,,,,,,,,,,,,,,,~~~~~",
        "1',,,,,,,,,,,,,,,,,,,,,,,,,,,,,,,'.',,,,,,,,,,,,,,,,,,,,,,,~~~~~",
        "1',,,,,,,,,,,,,,,,,,,,,,,,,,,,,,,'.',,,,,,,,,,,,,,,,,,,,,,,~~~~~",
        "1',,,,,,,,,,,,,,,,,,,,,,,,,,,,,,,'.',,,,,,,,,,,,,,,,,,,,,,,~~~~~",
        "1',,,,,,,,,,,,,,,,,,,,,,,,,,,,,,,'.',,,,,,,,,,,,,,,,,,,,,,,~~~~~",
        "1'''''''''''''''''''''''''''''''''.',,,,,,,,,,,,,,,,,,,,,,,~~~~~",
        "1'.................................',,,,,,,,,,,,,,,,,,,,,,,~~~~~",
        "1''''''''''''''''''''''''''''''''''',,,,,,,,,,,,,,,,,,,,,,,~~~~~",
        "1',,,,,,,,,,,,,,,,,,,,,,,,,,,,,,,,,,,,,,,,,,,,,,,,,,,,,,,,,~~~~~",
        "1',,,,,,,,,,,,,,,,,,,,,,,,,,,,,,,,,,,,,,,,,,,,,,,,,,,,,,,,,~~~~~",
        "1',,,,,,,,,,,,,,,,,,,,,,,,,,,,,,,,,,,,,,,,,,,,,,,,,,,,,,,,,~~~~~",
        "1',,,,,,,,,,,,,,,,,,,,,,,,,,,,,,,,,,,,,,,,,,,,,,,,,,,,,,,,,~~~~~",
        "1',,,,,,,,,,,,,,,,,,,,,,,,,,,,,,,,,,,,,,,,,,,,,,,,,,,,,,,,,~~~~~",
        "1',,,,,,,,,,,,,,,,,,,,,,,,,,,,,,,,,,,,,,,,,,,,,,,,,,,,,,,,,~~~~~",
        "1',,,,,,,,,,,,,,,,,,,,,,,,,,,,,,,,,,,,,,,,,,,,,,,,,,,,,,,,,~~~~~",
        "1',,,,,,,,,,,,,,,,,,,,,,,,,,,,,,,,,,,,,,,,,,,,,,,,,,,,,,,,,~~~~~",
        "1',,,,,,,,,,,,,,,,,,,,,,,,,,,,,,,,,,,,,,,,,,,,,,,,,,,,,,,,,~~~~~",
        "1',,,,,,,,,,,,,,,,,,,,,,,,,,,,,,,,,,,,,,,,,,,,,,,,,,,,,,,,,~~~~~",
        "1',,,,,,,,,,,,,,,,,,,,,,,,,,,,,,,,,,,,,,,,,,,,,,,,,,,,,,,,,~~~~~",
        "1',,,,,,,,,,,,,,,,,,,,,,,,,,,,,,,,,,,,,,,,,,,,,,,,,,,,,,,,,~~~~~",
        "1',,,,,,,,,,,,,,,,,,,,,,,,,,,,,,,,,,,,,,,,,,,,,,,,,,,,,,,,,~~~~~",
        "1',,,,,,,,,,,,,,,,,,,,,,,,,,,,,,,,,,,,,,,,,,,,,,,,,,,,,,,,,~~~~~",
        "1',,,,,,,,,,,,,,,,,,,,,,,,,,,,,,,,,,,,,,,,,,,,,,,,,,,,,,,,,~~~~~",
        "1',,,,,,,,,,,,,,,,,,,,,,,,,,,,,,,,,,,,,,,,,,,,,,,,,,,,,,,,,~~~~~",
        "1',,,,,,,,,,,,,,,,,,,,,,,,,,,,,,,,,,,,,,,,,,,,,,,,,,,,,,,,,~~~~~",
        "1',,,,,,,,,,,,,,,,,,,,,,,,,,,,,,,,,,,,,,,,,,,,,,,,,,,,,,,,,~~~~~",
        "1',,,,,,,,,,,,,,,,,,,,,,,,,,,,,,,,,,,,,,,,,,,,,,,,,,,,,,,,,~~~~~",
        "1',,,,,,,,,,,,,,,,,,,,,,,,,,,,,,,,,,,,,,,,,,,,,,,,,,,,,,,,,~~~~~",
        "1',,,,,,,,,,,,,,,,,,,,,,,,,,,,,,,,,,,,,,,,,,,,,,,,,,,,,,,,,~~~~~",
        "1',,,,,,,,,,,,,,,,,,,,,,,,,,,,,,,,,,,,,,,,,,,,,,,,,,,,,,,,,~~~~~",
        "1',,,,,,,,,,,,,,,,,,,,,,,,,,,,,,,,,,,,,,,,,,,,,,,,,,,,,,,,,~~~~~",
        "1',,,,,,,,,,,,,,,,,,,,,,,,,,,,,,,,,,,,,,,,,,,,,,,,,,,,,,,,,~~~~~",
        "1''''''''''''''''''''''''''''''',,,,,,,,,,,,,,,,,,,,,,,,,,,~~~~~",
        "1.............................'',,,,,,,,,,,,,,,,,,,,,,,,,,,~~~~~",
        "1''''''''''''''''''''''''''''''',,,,,,,,,,,,,,,,,,,,,,,,,,,~~~~~",
        "1',,,,,,,,,,,,,,,,,,,,,,,,,,,,,,,,,,,,,,,,,,,,,,,,,,,,,,,,,~~~~~",
        "1',,,,,,,,,,,,,,,,,,,,,,,,,,,,,,,,,,,,,,,,,,,,,,,,,,,,,,,,,~~~~~",
        "1',,,,,,,,,,,,,,,,,,,,,,,,,,,,,,,,,,,,,,,,,,,,,,,,,,,,,,,,,~~~~~",
        "1',,,,,,,,,,,,,,,,,,,,,,,,,,,,,,,,,,,,,,,,,,,,,,,,,,,,,,,,,~~~~~",
        "1',,,,,,,,,,,,,,,,,,,,,,,,,,,,,,,,,,,,,,,,,,,,,,,,,,,,,,,,,~~~~~",
        "1',,,,,,,,,,,,,,,,,,,,,,,,,,,,,,,,,,,,,,,,,,,,,,,,,,,,,,,,,~~~~~",
        "1',,,,,,,,,,,,,,,,,,,,,,,,,,,,,,,,,,,,,,,,,,,,,,,,,,,,,,,,,~~~~~",
        "1',,,,,,,,,,,,,,,,,,,,,,,,,,,,,,,,,,,,,,,,,,,,,,,,,,,,,,,,,~~~~~",
        "1',,,,,,,,,,,,,,,,,,,,,,,,,,,,,,,,,,,,,,,,,,,,,,,,,,,,,,,,,~~~~~",
        "1',,,,,,,,,,,,,,,,,,,,,,,,,,,,,,,,,,,,,,,,,,,,,,,,,,,,,,,,,~~~~~",
        "XX,,,,,,,,,,,,,,,,,,,,,,,,,,,,,,,,,,,,,,,,,,,,,,,,,,,,,,,,,~~~~~",
        " XX,,,,,,,,,,,,,,,,,,,,,,,,,,,,,,,,,,,,,,,,,,,,,,,,,,,,,,,,~~~~~",
        "  XXX,,,,,,,,,,,,,,,,,,,,,,,,,,,,,,,,,,,,,,,,,,,,,,,,,,,,,,~~~~~",
        "    XX,,,,,,,,,,,,,,,,,,,,,,,,,,,,,,,,,,,,,,,,,,,,,,,,,,,,,~~~~~",
        "     X,,,,,,,,,,,,,,,,,,,,,,,,,,,,,,,,,,,,,,,,,,,XXXXX,,,,,~~~~~",
        "     XX,,,,,,,,,,,,,,,,,,,,,,,,,,,,,,,,,,,,,,,XXXX   XXX,,,,~~~~",
        "      XXXX,,,XXX,,,,,,,,,,,,,,,,,,,,,,,,,,,,XXX        XXXXXX~~~",
        "         XXXXX XX,,,,,,,,,,,,,,,,,,,,,,,,,,XXX              XX~~",
        "                XX,,,,,,,,,,,,,,,,,,,,,,,XXX                 X~~",
        "                 XXXXXX,,,,,,,,,,,X,,,,,XX                   XX~",
        "                      XXXX,XXXXXXXXX,XXXX                     XX",
        "                         XXX       XXX                          ",
        "                                                                "
    ],
    "mapping": {
        ",": ["grass", "freeland"],
        "'": ["grass"],
        "Y": ["grass", "plant"],
        "T": ["grass", "tree"],
        "~": "water",
        "=": ["water", "bridge"],
        "o": ["grass", "stone"],
        "*": ["grass", "pebble"],
        "d": ["ground", "dummy"],
        "#": "wall",
        ":": ["floor", {
            "type": "spawner",
            "args": ["seed", 1, 600],
            "kwargs": {"initialSpawn": true}
        }],
        ";": ["floor", "seed"],
        ".": "ground",
        "+": "floor",
        "X": "rock",
        "^": ["spiketrap", "ground"],
        "1": [{
            "type": "roomexit",
            "args": ["begin", [-2, 0], [false, true]]
        }, "grass"],
        "%": [{
            "type": "roomexit",
            "args": ["overview", "begin"]
        }, "bridge", "water"],
        "r": ["grass", "rabbit"],
        "/": ["grass", "sword"],
        "!": ["grass", "club"],
        "]": ["grass", "armour"],
        " ": []
    }
}
